BBBBBBBBBBBBBBBBBBB
BBBBBBBBBBBBBBBBBBB
BBBBBBBBBBBBBBBBBBB
BBBBBBBBBBBBBBBBBBB
BBBBBBBBBBBBBBBBBBB
BBBBBBBBBBBBBBBBBBB
BBBBBBBBBBBBBWWWBBB
BBBBBBBBBBBBBWPWBBB
BBBWWWWWWWWWWWFWWWB
BWWWFFFFFFFFFFFFFWB
BWTFFFFFFFFFFFFFFWB
BWWWWFFFFFFFFFFFFWB
BBBBWWWWWWWWWWWWWWB
BBBBBBBBBBBBBBBBBBB
BBBBBBBBBBBBBBBBBBB