BBBBBBBBBBBBBBBBBBB
BWWWWWBBBBBBWWWWWBB
BWFFFWWWWWWWWFFFWBB
BWFFFWWFFFFWWFFFWBB
BWWFFFFFFFFFFFFWWBB
BBWFWWWWFFWWWWFWBBB
BBWFWBWFFFFWBWFWBBB
BBWPWBWFFFFWBWTWBBB
BBWWWBWWWWWWBWWWBBB
BBBBBBBBBBBBBBBBBBB
BBBBBBBBBBBBBBBBBBB
BBBBBBBBBBBBBBBBBBB
BBBBBBBBBBBBBBBBBBB
BBBBBBBBBBBBBBBBBBB
BBBBBBBBBBBBBBBBBBB