BBBBBBBBBBBBBBBBBBB
BBBBBBBBBBBBBBBBBBB
BBBBBBBBBBBBBBBBBBB
BBBBBBBBBBBBBBBBBBB
BBBBBBBBBBBBBBBBBBB
BBBBBBBBBBBBBBBBBBB
BBBBBBBBBBBBBWWWBBB
BBBBBBBBBBBBBWTWBBB
BBBBWWWWWWWWWWFWWWB
BWWWWFFFWFFFFWFFFWB
BWPFFFFFFFFFFWFFFWB
BWWWFFFFFFFFFFFFFWB
BBBWWWWFFFWWWWWWWWB
BBBBBBWWWWWBBBBBBBB
BBBBBBBBBBBBBBBBBBB