BBBBBBBBBBBBBBBBBBB
BWWWWWBBBBBBWWWWWBB
BWFFFWWWWWWWWFFFWBB
BWFWFWWFFFFWWFWFWBB
BWFFFFFFFFFFFFFFWBB
BWWFWWWWFFWWWWFWWBB
BBWFWBWFFFFWBWFWBBB
BBWPWBWFFFFWBWTWBBB
BBWWWBWWWWWWBWWWBBB
BBBBBBBBBBBBBBBBBBB
BBBBBBBBBBBBBBBBBBB
BBBBBBBBBBBBBBBBBBB
BBBBBBBBBBBBBBBBBBB
BBBBBBBBBBBBBBBBBBB
BBBBBBBBBBBBBBBBBBB