BBBBBBBBBBBBBBBBBBB
BBBBBBBBBBBBBBBBBBB
BBBBBBBBBBBBBBBBBBB
BBBBBBBBBBBBBBBBBBB
BBBBBBBBBBBBBBBBBBB
BBBBBBBBBBBBBBBBBBB
BBBBBBBBBBBBBWWWBBB
BBBBBBBBBBBBBWPWBBB
BBBBWWWWWWWWWWFWWWB
BWWWWFFFFFFFFFFFFWB
BWTFFFFFFFFFFFFFFWB
BWWWFFFFFFFFFFFFFWB
BBBWWWWWWWWWWWWWWWB
BBBBBBBBBBBBBBBBBBB
BBBBBBBBBBBBBBBBBBB