BBBBBBBBBBBBBBBBBBB
BBBBBBBBBBBBBBBBBBB
BBBBBBBBBBBBBBBBBBB
WWWWWBBBWWWWWBBBBBB
WFFFWWWWWFFFWBBBBBB
WFWFWWPWWFWFWBBBBBB
WFFHFFHFFHFFWWWWBBB
WWWFWWFWWFWWWWTWBBB
BWWFWWFWWFWWWWFWBBB
BWFFFFHFFHFFWFFWWBB
BWFFFWFWWFWFWFFFWBB
BWFFFFFWWFFFWWFFWBB
BWFFWWWWWWWWWWFFWBB
BWWFFFFFFFFFFFFFWBB
BBWWWWWWWWWWWWWWWBB