BBBBBBBBBBBBBBBBBBB
BBBBBBBBBBBBBBBBBBB
BBBBBBBBBBBBBBBBBBB
BBBBBBBBBBBBBBBBBBB
BBBBBBBBBBBBBBBBBBB
BBBBBBBBBBBBBBBBBBB
BBWWWBBBBBBBBWWWBBB
BBWTWBBBBBBBBWPWBBB
BBWFWBBBBWWWWWFWBBB
BBWFWWWWWWFFWWFWBBB
BBWFFFFFFFFFFFFWBBB
BBWFFWWFFWWWWFFWBBB
BBWWWWWWWWBBWWWWBBB
BBBBBBBBBBBBBBBBBBB
BBBBBBBBBBBBBBBBBBB