BBBBBBBBBBBBBBBBBBB
BBBBBBBBBBBBBBBBBBB
BBBBBBBBBBBBBBBBBBB
BBBBBBBBBBBBBBBBBBB
BBBBBBBBBBBBBBBBBBB
BBBBBBBBBBBBBBBBBBB
BBBBBBBBBBBBBBBBBBB
BBBBBBBBBBBBBBBBBBB
BBBBBBBBBBBBBBBBBBB
BWWWWWWWWWWWWWWWBBB
BWTFFFFFFFFFFFPWBBB
BWWWWWWWWWWWWWWWBBB
BBBBBBBBBBBBBBBBBBB
BBBBBBBBBBBBBBBBBBB
BBBBBBBBBBBBBBBBBBB