BBBBBBBBBBBBBBBBBBB
BBBBBBBBBBBBBBBBBBB
BBBBBBBBBBBBBBBBBBB
BBBBBBBBBBBBBBBBBBB
BBBBBBBBBBBBBBBBBBB
BBBBBBBBBBBBBBBBBBB
BBBBBBBBBBBBBWWWBBB
BBBBBBWWWWWBBWTWBBB
BBBWWWWFFFWWWWFWWWB
BWWWFFFFFFFFFWFFFWB
BWPFFFFFFFFFFWFFFWB
BWWWWFFFWFFFFFFFFWB
BBBBWWWWWWWWWWWWWWB
BBBBBBBBBBBBBBBBBBB
BBBBBBBBBBBBBBBBBBB