BBBBBBBBBBBBBBBBBBB
BBBBBBBBBBBBBBBBBBB
BWWWWWWWWWWWWWWWBBB
BWFFFFFFFFFFFFFWBBB
BWFWWWWWWWWWWWFWWWW
BWFWWWTFFFFFFFHFFFW
BWFWWWWWWWWWWWFWWFW
BWFWWWWWWWWWWWPWWFW
BWFWWWWWWWWWWWWWWFW
BWFWWFFFFWWFFWWWWFW
BWFFFFFFFFFFFFFFFFW
BWWWWWWWFFFFFFWWWWW
BBBBBBBWWWWWWWWBBBB
BBBBBBBBBBBBBBBBBBB
BBBBBBBBBBBBBBBBBBB