BWWWWWWWWWWWWWWWBBB
BWTFFFFWFFFFFFPWBBB
BW~FFFFFFFFFFFWWBBB
BWF~FFF~~FFWFWFWBBB
BWWWWWWWWWWWWWWWBBB