BBBBBBBBBBBBBBBBBBB
BBBBBBBBBBBBBBBBBBB
BBBBBBBBBBBBBBBBBBB
BBBBBBBBBBBBBBBBBBB
BBBBBBBBBBBBBBBBBBB
BBBBBBBBBBBBBBBBBBB
BBBBBBBBBBBBBWWWBBB
BBBBBBBBBBBBBWTWBBB
BBBBBBBBBBBBBWFWBBB
BWWWWWWWBWWWWWFWBBB
BWPFFFFWBWFFFFFWBBB
BWWWWWFWWWFWWWWWBBB
BBBBBWFFFFFWBBBBBBB
BBBBBWWWWWWWBBBBBBB
BBBBBBBBBBBBBBBBBBB