BBBBBBBBBBBBBBBBBBB
BBBBBBBBBBBBBBBBBBB
BBBBBBBBBBBBBBBBBBB
BBBBBBBBBBBBBBBBBBB
BBBBBBBBBBBBBBBBBBB
BBBBBBBBBBBBBBBBBBB
BBWWWBBBBBBBBWWWBBB
BBWTWBBBBBBBBWPWBBB
BBWFWWWWWBBBBWFWBBB
BBWFWWFFWWWWWWFWBBB
BBWFFFFFFFFFFFFWBBB
BBWFFWWWWFFWWFFWBBB
BBWWWWBBWWWWWWWWBBB
BBBBBBBBBBBBBBBBBBB
BBBBBBBBBBBBBBBBBBB